
                                                                                                                                                                                                                                                                                                             

                                                                                                                                                                                                                                                                                                             

                                                                                                                                                                                                                          %%%%%%%%%                                                                          

                                                                                                                                                                                                                      %%%%%%%%%%%%%%                                                                         

                                                                                                                                                                                                                   %%%%%%%%%%%%%%%%%                                                                         

                                                                                                                                                                                                                %%%%%%%%%%%%%%%%%%%%                                                                         

                                                                                                                                                                                                             %%%%%%%%%%%%%%%%%%%%%%                                                                          

                                                                                                                                                                                                           %%%%%%%%%%%%%%%%%%%%%%                                                                            

                                                                                                                                                                                                         %%%%%%%%%%%%%%%%%%%%%%%                                                                             

                                                                                                                                                                                                      %%%%%%%%%%%%%%%%%%%%%%%%                                                                               

                                                                                                                                                                                                    %%%%%%%%%%%%%%%%%%%%%%%%%                                                                                

                                                                                                                                                                                                 %%%%%%%%%%%%%%%%%%%%%%%%%%                                                                                  

                                                                                                                                                                                              %%%%%%%%%%%%%%%%%%%%%%%%%%%                                                                                    

                                                                                                                                                                                           %%%%%%%%%%%%%%%%%%%%%%%%%%%%                                                                                      

                                                                                                                                                                                        %%%%%%%%%%%%%%%%%%%%%%%%%%%%%                                                                                        

                                                                                                                                                                                     %%%%%%%%%%%%%%%%%%%%%%%%%%%%%         %%%%%%%%                                                                          

                                                                                                                                                                                  %%%%%%%%%%%%%%%%%%%%%%%%%%%%%%      %%%%%%%%%%%%%%                                                                         

                                                                                                                                                                              %%%%%%%%%%%%%%%%%%%%%%%%%%%%%%%%     %%%%%%%%%%%%%%%%%                                                                         

                                                                                                                                                                           %%%%%%%%%%%%%%%%%%%%%%%%%%%%%%%%     %%%%%%%%%%%%%%%%%%%%                                                                         

                                                                                                                                                                       %%%%%%%%%%%%%%%%%%%%%%%%%%%%%%%%%      %%%%%%%%%%%%%%%%%%%%%                                                                          

                                                                                                                                                                   %%%%%%%%%%%%%%%%%%%%%%%%%%%%%%%%%%      %%%%%%%%%%%%%%%%%%%%%%%                                                                           

                                                                                                                                                               %%%%%%%%%%%%%%%%%%%%%%%%%%%%%%%%%%%       %%%%%%%%%%%%%%%%%%%%%%%                                                                             

                                                                                                                                                           %%%%%%%%%%%%%%%%%%%%%%%%%%%%%%%%%%%%..      %%%%%%%%%%%%%%%%%%%%%%%%                                                                              

                                                                                                                                                       %%%%%%%%%%%%%%%%%%%%%%%%%%%%%%%%%%%%....     %%%%%%%%%%%%%%%%%%%%%%%%%                                                                                

                                                                                                                                                  %%%%%%%%%%%%%%%%%%%%%%%%%%%%%%%%%%%%%......    %%%%%%%%%%%%%%%%%%%%%%%%%%                                                                                  

                                                                                                                                              %%%%%%%%%%%%%%%%%%%%%%%%%%%%%%%%%%%%%........    %%%%%%%%%%%%%%%%%%%%%%%%%%                                                                                    

                                                                                                                                          %%%%%%%%%%%%%%%%%%%%%%%%%%%%%%%%%%%%%.........    %%%%%%%%%%%%%%%%%%%%%%%%%%%                                                                                      

                                                                                                                                     %%%%%%%%%%%%%%%%%%%%%%%%%%%%%%%%%%%%%%...........   %%%%%%%%%%%%%%%%%%%%%%%%%%%%                                                                                        

                                                                                                                                 %%%%%%%%%%%%%%%%%%%%%%%%%%%%%%%%%%%%%%............   %%%%%%%%%%%%%%%%%%%%%%%%%%%%%                                                                                          

                                                                                                                             %%%%%%%%%%%%%%%%%%%%%%%%%%%%%%%%%%%%%%.............. %%%%%%%%%%%%%%%%%%%%%%%%%%%%%%%                                                                                            

                                                                                                                         %%%%%%%%%%%%%%%%%%%%%%%%%%%%%%%%%%%%%................ %%%%%%%%%%%%%%%%%%%%%%%%%%%%%%%                                                                                               

                                                                                                                     %%%%%%%%%%%%%%%%%%%%%%%%%%%%%%%%%%%%%.................%%%%%%%%%%%%%%%%%%%%%%%%%%%%%%%%                                                                                                  

                                                                                                                 %%%%%%%%%%%%%%%%%%%%%%%%%%%%%%%%%%%%%..................%%%%%%%%%%%%%%%%%%%%%%%%%%%%%%%%%                                                                                                    

                                                                                                              %%%%%%%%%%%%%%%%%%%%%%%%%%%%%%%%%%%...................%%%%%%%%%%%%%%%%%%%%%%%%%%%%%%%%%%                                                                                                       

                                                                                                           %%%%%%%%%%%%%%%%%%%%%%%%%%%%%%%%%%...................%%%%%%%%%%%%%%%%%%%%%%%%%%%%%%%%%%                P                                                                                          

                                                                                                       %%%%%%%%%%%%%%%%%%%%%%%%%%%%%%%%%%...................%%%%%%%%%%%%%%%%%%%%%%%%%%%%%%%%%%%                                                                                                              

                                                                                                    %%%%%%%%%%%%%%%%%%%%%%%%%%%%%%%%%..................%%%%%%%%%%%%%%%%%%%%%%%%%%%%%%%%%%%%%                                                                                                                 

                                                                                                  %%%%%%%%%%%%%%%%%%%%%%%%%%%%%%%%.................%%%%%%%%%%%%%%%%%%%%%%%%%%%%%%%%%%%%%                                                                                                                     

                                                                                               %%%%%%%%%%%%%%%%%%%%%%%%%%%%%%% ................%%%%%%%%%%%%%%%%%%%%%%%%%%%%%%%%%%%%%                                                                                                                         

                                                                                            %%%%%%%%%%%%%%%%%%%%%%%%%%%%%%% ..............%%%%%%%%%%%%%%%%%%%%%%%%%%%%%%%%%%%%%%                                                                                                                             

                                                                                          %%%%%%%%%%%%%%%%%%%%%%%%%%%%%   ............%%%%%%%%%%%%%%%%%%%%%%%%%%%%%%%%%%%%%%                                                                                                                                 

                                                                                        %%%%%%%%%%%%%%%%%%%%%%%%%%%%   ...........%%%%%%%%%%%%%%%%%%%%%%%%%%%%%%%%%%%%%%                                                                                                                                     

                                                                                      %%%%%%%%%%%%%%%%%%%%%%%%%%%    .........%%%%%%%%%%%%%%%%%%%%%%%%%%%%%%%%%%%%%                                                                                                                                          

                                                                                    %%%%%%%%%%%%%%%%%%%%%%%%%%    ........%%%%%%%%%%%%%%%%%%%%%%%%%%%%%%%%%%%%%                                                                                                                                              

                                                                                  %%%%%%%%%%%%%%%%%%%%%%%%%%    ......%%%%%%%%%%%%%%%%%%%%%%%%%%%%%%%%%%%%%                                                                                                                                                  

                                                                                %%%%%%%%%%%%%%%%%%%%%%%%%     ....%%%%%%%%%%%%%%%%%%%%%%%%%%%%%%%%%%%%                                                                                                                                                       

                                                                              %%%%%%%%%%%%%%%%%%%%%%%%      ..%%%%%%%%%%%%%%%%%%%%%%%%%%%%%%%%%%%%                                                                                                                                                           

                                                                             %%%%%%%%%%%%%%%%%%%%%%%       %%%%%%%%%%%%%%%%%%%%%%%%%%%%%%%%%%%                                                                                                                                                               

                                                                           %%%%%%%%%%%%%%%%%%%%%%%      %%%%%%%%%%%%%%%%%%%%%%%%%%%%%%%%%%                                                                                                                                                                   

                                                                          %%%%%%%%%%%%%%%%%%%%%      %%%%%%%%%%%%%%%%%%%%%%%%%%%%%%%%%                                                                                                                                                                       

                                                                         %%%%%%%%%%%%%%%%%%%%     %%%%%%%%%%%%%%%%%%%%%%%%%%%%%%%%                                                                                                                                                                           

                                                                         %%%%%%%%%%%%%%%%%     %%%%%%%%%%%%%%%%%%%%%%%%%%%%%%%%                                                                                                                                                                              

                                                                         %%%%%%%%%%%%%%      %%%%%%%%%%%%%%%%%%%%%%%%%%%%%%                                                                                                                                                                                  

                                                                          %%%%%%%%         %%%%%%%%%%%%%%%%%%%%%%%%%%%%%                                                                                                                                                                                     

                                                                                        %%%%%%%%%%%%%%%%%%%%%%%%%%%%%                                                                                                                                                                                        

                                                                                      %%%%%%%%%%%%%%%%%%%%%%%%%%%%                                                                                                                                                                                           

                                                                                    %%%%%%%%%%%%%%%%%%%%%%%%%%%                                                                                                                                                                                              

                                                                                  %%%%%%%%%%%%%%%%%%%%%%%%%%                                                                                                                                                                                                 

                                                                                %%%%%%%%%%%%%%%%%%%%%%%%%                                                                                                                                                                                                    

                                                                               %%%%%%%%%%%%%%%%%%%%%%%%                                                                                                                                                                                                      

                                                                             %%%%%%%%%%%%%%%%%%%%%%%                                                                                                                                                                                                         

                                                                            %%%%%%%%%%%%%%%%%%%%%%                                                                                                                                                                                                           

                                                                          %%%%%%%%%%%%%%%%%%%%%%                                                                                                                                                                                                             

                                                                         %%%%%%%%%%%%%%%%%%%%                                                                                                                                                                                                                

                                                                         %%%%%%%%%%%%%%%%%                                                                                                                                                                                                                   

                                                                         %%%%%%%%%%%%%%                                                                                                                                                                                                                      

                                                                          %%%%%%%%%                                                                                                                                                                                                                          

                                                                                                                                                                                                                                                                                                             

                                                                                                                                                                                                                                                                                                             

                                                                                                                                                                                                                                                                                                             

                                                                                                                                                                                                                                                                                                             

                                                                                                                                                                                                                                                                                                             

                                                                                                                                                                                                                                                                                                             

                                                                                                                                                                                                                                                                                                             

