                                                                                           
                                                                                           
                                                                                           
                                                                                           
                                                                                           
                                                                                           
                                                                                           
                                                                                           
                                                                                           
                                                                                           
                                                                                           
                                                                                           
                                                                                           
                                                                                           
                                                                                           
                                                                                           
                                                                                           
                                                                                           
                                                                                           
                                                                                           
                                                                                           
                                                                                           
                                                                                           
                                                                                           
                                                                                           
                                                                                           
                                                                                           
                                                                                           
                                                                                           
                                                                                           
                                                                                           
                                                                                           
                                                                                           
                                                                                           
                                                                                           
                                                                                           
                                                                                           
                                                     %%    %%%                             
                                                    %%%    %%%                             
                                                   %%%%   %%%%                             
                                                   %%%%  %%%%%                             
                                                  %%%%%  %%%%%                             
                                                  %%%%% %%%%%                              
                                                 %%%%%% %%%%%                              
                                                 %%%%% %%%%%%                              
                                                %%%%%% %%%%%                               
                                                %%%%%% %%%%%                               
                                                %%%%% %%%%%%                               
                                               %%%%%% %%%%%                                
                                               %%%%% %%%%%%                                
                                              %%%%%% %%%%%                                 
                                              %%%%%  %%%%%                                 
                                              %%%%% %%%%%%                                 
                                              %%%%% %%%%%                                  
                                             %%%%% .%%%%%                                  
                                             %%%%% %%%%%%                                  
                                             %%%%%.%%%%%                                   
                                            %%%%% .%%%%%                                   
                                            %%%%% .%%%%%                                   
                                            %%%%%.%%%%%                                    
                                            %%%% .%%%%%                                    
                                           %%%%%..%%%%%                                    
                                           %%%%%..%%%%                                     
                                           %%%% .%%%%%                                     
                                           %%%%..%%%%%                                     
                                          %%%%%..%%%%                                      
                                          %%%%%..%%%%                                      
                                          %%%%..%%%%%                                      
                                          %%%%..%%%%%                                      
                                         %%%%%..%%%%                                       
                                         %%%%%..%%%%                                       
                                         %%%%...%%%%                                       
                                         %%%%..%%%%%                                       
                                        %%%%%..%%%%                                        
                                        %%%%%..%%%%                                        
                                        %%%%...%%%%                                        
                                        %%%%..%%%%%                                        
                                        %%%%..%%%%%                                        
                                       %%%%%..%%%%                                         
                                       %%%%...%%%%                                         
                                       %%%%..%%%%%                                         
                                       %%%%..%%%%%                                         
                                      %%%%%..%%%%                                          
                                      %%%%%..%%%%                                          
                                      %%%%..%%%%%                                          
                                      %%%%..%%%%%                                          
                                     %%%%%..%%%%                                           
                                     %%%%%. %%%%                                           
                                     %%%%..%%%%%                                           
                                    %%%%%..%%%%%                                           
                                    %%%%%. %%%%                                            
                                    %%%%%.%%%%%                                            
                                   %%%%%. %%%%%                                            
                                   %%%%%. %%%%%                                            
                                   %%%%%.%%%%%                                             
                                  %%%%%% %%%%%                                             
                                  %%%%%. %%%%%                                             
                                  %%%%% %%%%%                                              
                                 %%%%%% %%%%%                                              
                                 %%%%%  %%%%%                                              
                                 %%%%% %%%%%%                                              
                                %%%%%% %%%%%                                               
                                %%%%% %%%%%%                                               
                               %%%%%% %%%%%                                                
                               %%%%% %%%%%%                                                
                               %%%%% %%%%%%  P                                             
                              %%%%%% %%%%%                                                 
                              %%%%% %%%%%%                                                 
                              %%%%% %%%%%                                                  
                             %%%%%  %%%%%                                                  
                             %%%%%  %%%%                                                   
                             %%%%   %%%%                                                   
                             %%%    %%%                                                    
                             %%%    %%                                                     
                                                                                           
                                                                                           
                                                                                           
                                                                                           
                                                                                           
                                                                                           
                                                                                           
                                                                                           
                                                                                           
                                                                                           
                                                                                           
                                                                                           
                                                                                           
                                                                                           
                                                                                           
                                                                                           
                                                                                           
                                                                                           
                                                                                           
                                                                                           
                                                                                           
                                                                                           
                                                                                           
                                                                                           
                                                                                           
                                                                                           
                                                                                           
                                                                                           
                                                                                           
                                                                                           
                                                                                           
                                                                                           
                                                                                           
                                                                                           
                                                                                           
                                                                                           
                                                                                           
