                                                                                           
                                                                                           
                                                                                           
                                                                                           
                                                                                           
                                                                                           
                                                                                           
                                                                                           
                                                                                           
                                                                                           
                                                                                           
                                                                                           
                                                                                           
                                                                                           
                                                                                           
                                                                                           
                                                                                           
                                                                                           
                                                                                           
                                                                                           
                                                                                           
                                                                                           
                                                                                           
                                                                                           
                                                                                           
                                                                                           
                                                                                           
                                                               %%  %%                      
                                                              %%% %%%                      
                                                             %%%%%%%%                      
                                                            %%%%%%%%%                      
                                                           %%%%%%%%%%                      
                                                          %%%%%%%%%%                       
                                                         %%%%%%%%%%%                       
                                                        %%%%%%%%%%%                        
                                                       %%%%%%%%%%%                         
                                                      %%%%%%%%%%%%                         
                                                      %%%%%%%%%%%                          
                                                     %%%%%%%%%%%                           
                                                    %%%%%%%%%%%                            
                                                    %%%%%%%%%%%                            
                                                   %%%%%%%%%%%                             
                                                   %%%%%%%%%%                              
                                                  %%%%%%%%%%%                              
                                                  %%%%%%%%%%                               
                                                 %%%%%%%%%%%                               
                                                 %%%%%%%%%%                                
                                                 %%%%%%%%%%                                
                                                %%%%%%%%%%                                 
                                                %%%%%%%%%%                                 
                                               %%%%%%%%%%                                  
                                               %%%%%%%%%%                                  
                                               %%%%%%%%%%                                  
                                              %%%%%%%%%%                                   
                                              %%%%%%%%%%                                   
                                             %%%%%%%%%%                                    
                                             %%%%%%%%%%                                    
                                            %%%%%%%%%%%                                    
                                            %%%%%%%%%%                                     
                                            %%%%%%%%%%                                     
                                           %%%%%%%%%%%                                     
                                           %%%%%%%%%%                                      
                                           %%%%%%%%%%                                      
                                          %%%%%%%%%%%                                      
                                          %%%%%%%%%%%                                      
                                         %%%%%%%%%%%                                       
                                         %%%%%%%%%%%                                       
                                         %%%%%%%%%%%                                       
                                        %%%%%%%%%%%%                                       
                                        %%%%%%%%%%%                                        
                                        %%%%%%%%%%%                                        
                                       %%%%%%%%%%%%                                        
                                       %%%%%%%%%%%%                                        
                                       %%%%%%%%%%%                                         
                                      %%%%%%%%%%%%                                         
                                      %%%%%%%%%%%%                                         
                                      %%%%%%%%%%%%                                         
                                     %%%%%%%%%%%%                                          
                                     %%%%%%%%%%%%                                          
                                     %%%%%%%%%%%%                                          
                                    %%%%%%%%%%%%%                                          
                                    %%%%%%%%%%%%%                                          
                                    %%%%%%%%%%%%                                           
                                   %%%%%%%%%%%%%                                           
                                   %%%%%%%%%%%%%                                           
                                  %%%% %%%%%%%%%                                           
                                  %%%%%%%%%%%%%                                            
                                  %%%%%%%%%%%%%                                            
                                 %%%% %%%%%%%%%                                            
                                 %%%% %%%%%%%%%                                            
                                %%%% %%%%%%%%%                                             
                                %%%% %%%%%%%%%                                             
                                %%%% %%%%%%%%%                                             
                               %%%% %%%%%%%%%%                                             
                               %%%% %%%%%%%%%                                              
                              %%%%  %%%%%%%%%                                              
                              %%%% %%%%%%%%%%                                              
                             %%%%  %%%%%%%%%                                               
                             %%%% %%%%%%%%%%                                               
                            %%%%% %%%%%%%%%%                                               
                            %%%%  %%%%%%%%%%                                               
                           %%%%% %%%%%%%%%%                                                
                           %%%%  %%%%%%%%%%                                                
                          %%%%%.%%%%%%%%%%                                                 
                         %%%%% .%%%%%%%%%%                                                 
                         %%%% .%%%%%%%%%%%   P                                             
                        %%%%%..%%%%%%%%%%                                                  
                        %%%% .%%%%%%%%%%%                                                  
                        %%%%..%%%%%%%%%%                                                   
                       %%%% .%%%%%%%%%%%                                                   
                       %%% .%%%%%%%%%%%                                                    
                       %%% .%%%%%%%%%%%                                                    
                       %%  %%%%%%%%%%%                                                     
                          %%%%%%%%%%%                                                      
                         %%%%%%%%%%%%                                                      
                         %%%%%%%%%%%                                                       
                        %%%%%%%%%%%                                                        
                       %%%%%%%%%%%                                                         
                       %%%%%%%%%%                                                          
                      %%%%%%%%%%                                                           
                      %%%%%%%%%                                                            
                      %%%%%%%%                                                             
                      %%% %%%                                                              
                      %%  %%                                                               
                                                                                           
                                                                                           
                                                                                           
                                                                                           
                                                                                           
                                                                                           
                                                                                           
                                                                                           
                                                                                           
                                                                                           
                                                                                           
                                                                                           
                                                                                           
                                                                                           
                                                                                           
                                                                                           
                                                                                           
                                                                                           
                                                                                           
                                                                                           
                                                                                           
                                                                                           
                                                                                           
                                                                                           
                                                                                           
                                                                                           
                                                                                           
