
                                                                                                                                                                                                                                                                                                             

                                                                                                                                                                                                                                                                                                             

                                                                                                                                                                                                                                               %%%%%%%%                                                      

                                                                                                                                                                                                                                             %%%%%%%%%%                                                      

                                                                                                                                                                                                                            %%%%%          %%%%%%%%%%%%                                                      

                                                                                                                                                                                                                         %%%%%%%%%        %%%%%%%%%%%%%                                                      

                                                                                                                                                                                                                      %%%%%%%%%%%%      %%%%%%%%%%%%%%                                                       

                                                                                                                                                                                                                    %%%%%%%%%%%%%      %%%%%%%%%%%%%%                                                        

                                                                                                                                                                                                                  %%%%%%%%%%%%%%      %%%%%%%%%%%%%%                                                         

                                                                                                                                                                                                                %%%%%%%%%%%%%%%     %%%%%%%%%%%%%%%%                                                         

                                                                                                                                                                                                               %%%%%%%%%%%%%%      %%%%%%%%%%%%%%%%%%                                                        

                                                                                                                                                                                                             %%%%%%%%%%%%%%%      %%%%%%%%%%%%%%%%%%%%%                                                      

                                                                                                                                                                                                           %%%%%%%%%%%%%%%     .%%%%%%%%%%%%%%%%%%%%%%%                                                      

                                                                                                                                                                                                         %%%%%%%%%%%%%%%%   ...%%%%%%%%%%%%%%%%%%%%%%%%                                                      

                                                                                                                                                                                                        %%%%%%%%%%%%%%%  .....%%%%%%%%%%%%%%%%%%%%%%%%%                                                      

                                                                                                                                                                                                      %%%%%%%%%%%%%%%% .....%%%%%%%%%%%%%%%%%%%%%%%%%%                                                       

                                                                                                                                                                                                    %%%%%%%%%%%%%%%% .....%%%%%%%%%%%%%%%%%%%%%%%%%%%                                                        

                                                                                                                                                                                                  %%%%%%%%%%%%%%%%  .....%%%%%%%%%%%%%%%%%%%%%%%%%%%                                                         

                                                                                                                                                                                                %%%%%%%%%%%%%%%%  .....%%%%%%%%%%%%%%%%%%%%%%%%%%%%                                                          

                                                                                                                                                                                             %%%%%%%%%%%%%%%%%%  ....%%%%%%%%%%%%%%%%%%%%%%%%%%%%%                                                           

                                                                                                                                                                                           %%%%%%%%%%%%%%%%%%   ....%%%%%%%%%%%%%%%%%%%%%%%%%%%%%                                                            

                                                                                                                                                                                         %%%%%%%%%%%%%%%%%%   ....%%%%%%%%%%%%%%%%%%%%%%%%%%%%%%                                                             

                                                                                                                                                                                       %%%%%%%%%%%%%%%%%%     ..%%%%%%%%%%%%%%%%%%%%%%%%%%%%%%%                                                              

                                                                                                                                                                                    %%%%%%%%%%%%%%%%%%%      .%%%%%%%%%%%%%%%%%%%%%%%%%%%%%%%%                                                               

                                                                                                                                                                                  %%%%%%%%%%%%%%%%%%%       %%%%%%%%%%%%%%%%%%%%%%%%%%%%%%%%%                                                                

                                                                                                                                                                               %%%%%%%%%%%%%%%%%%%       %%%%%%%%%%%%%%%%%%%%%%%%%%%%%%%%%%%                                                                 

                                                                                                                                                                             %%%%%%%%%%%%%%%%%%%       %%%%%%%%%%%%%%%%%%%%%%%%%%%%%%%%%%%%                                                                  

                                                                                                                                                                          %%%%%%%%%%%%%%%%%%%%      %%%%%%%%%%%%%%%%%%%%%%%%%%%%%%%%%%%%%%                                                                   

                                                                                                                                                                       %%%%%%%%%%%%%%%%%%%%       %%%%%%%%%%%%%%%%%%%%%%%%%%%%%%%%%%%%%%%                                                                    

                                                                                                                                                                     %%%%%%%%%%%%%%%%%%%%      %%%%%%%%%%%%%%%%%%%%%%%%%%%%%%%%%%%%%%%%                                                                      

                                                                                                                                                                  %%%%%%%%%%%%%%%%%%%%%     %%%%%%%%%%%%%%%%%%%%%%%%%%%%%%%%%%%%%%%%%%                                                                       

                                                                                                                                                               %%%%%%%%%%%%%%%%%%%%%     %%%%%%%%%%%%%%%%%%%%%%%%%%%%%%%%%%%%%%%%%%%%                                                                        

                                                                                                                                                            %%%%%%%%%%%%%%%%%%%%%     %%%%%%%%%%%%%%%%%%%%%%%%%%%%%%%%%%%%%%%%%%%%%                                                                          

                                                                                                                                                         %%%%%%%%%%%%%%%%%%%%%%    %%%%%%%%%%%%%%%%%%%%%%%%%%%%%%%%%%%%%%%%%%%%%%%                                                                           

                                                                                                                                                      %%%%%%%%%%%%%%%%%%%%%%   %%%%%%%%%%%%%%%%%%%%%%%%%%%%%%%%%%%%%%%%%%%%%%%%%                                                                             

                                                                                                                                                   %%%%%%%%%%%%%%%%%%%%%%   %%%%%%%%%%%%%%%%%%%%%%%%%%%%%%%%%%%%%%%%%%%%%%%%%%%                                                                              

                                                                                                                                                 %%%%%%%%%%%%%%%%%%%%%  %%%%%%%%%%%%%%%%%%%%%%%%%%%%%%%%%%%%%%%%%%%%%%%%%%%%%                                                                                

                                                                                                                                              %%%%%%%%%%%%%%%%%%%%% %%%%%%%%%%%%%%%%%%%%%%%%%%%%%%%%%%%%%%%%%%%%%%%%%%%%%%%                                                                                  

                                                                                                                                           %%%%%%%%%%%%%%%%%%%%%%%%%%%%%%%%%%%%%%%%%%%%%%%%%%%%%%%%%%%%%%%%%%%%%%%%%%%%%%                                                                                    

                                                                                                                                        %%%%%%%%%%%%%%%%%%%%%%%%%%%%%%%%%%%%%%%%%%%%%%%%%%%%%%%%%%%%%%%%%%%%%%%%%%%%%%%                                                                                      

                                                                                                                                     %%%%%%%%%%%%%%%%%%%%%%%%%%%%%%%%%%%%%%%%%%%%%%%%%%%%%%%%%%%%%%%%%%%%%%%%%%%%%%%%                                                                                        

                                                                                                                                  %%%%%%%%%%%%%%%%%%%%%%%%%%%%%%%%%%%%%%%%%%%%%%%%%%%%%%%%%%%%%%%%%%%%%%%%%%%%%%%%%                                                                                          

                                                                                                                               %%%%%%%%%%%%%%%%%%%%%%%%%%%%%%%%%%%%%%%%%%%%%%%%%%%%%%%%%%%%%%%%%%%%%%%%%%%%%%%%%%                                                                                            

                                                                                                                             %%%%%%%%%%%%%%%%%%%%%%%%%%%%%%%%%%%%%%%%%%%%%%%%%%%%%%%%%%%%%%%%%%%%%%%%%%%%%%%%%                                                                                               

                                                                                                                          %%%%%%%%%%%%%%%%%%%%%%%%%%%%%%%%%%%%%%%%%%%%%%%%%%%%%%%%%%%%%%%%%%%%%%%%%%%%%%%%%                                                                                                  

                                                                                                                       %%%%%%%%%%%%%%%%%%%%%%%%%%%%%%%%%%%%%%%%%%%%%%%%%%%%%%%%%%%%%%%%%%%%%%%%%%%%%%%%%%                                                                                                    

                                                                                                                     %%%%%%%%%%%%%%%%%%%%%%%%%%%%%%%%%%%%%%%%%%%%%%%%%%%%%%%%%%%%%%%%%%%%%%%%%%%%%%%%%                                                                                                       

                                                                                                                  %%%%%%%%%%%%%%%%%%%%%%%%%%%%%%%%%%%%%%%%%%%%%%%%%%%%%%%%%%%%%%%%%%%%%%%%%%%%%%%%                                                                                                           

                                                                                                                %%%%%%%%%%%%%%%%%%%%%%%%%%%%%%%%%%%%%%%%%%%%%%%%%%%%%%%%%%%%%%%%%%%%%%%%%%%%%%%                                                                                                              

                                                                                                              %%%%%%%%%%%%%%%%%%%%%%%%%%%%%%%%%%%%%%%%%%%%%%%%%%%%%%%%%%%%%%%%%%%%%%%%%%%%%                       P                                                                                          

                                                                                                           %%%%%%%%%%%%%%%%%%%%%%%%%%%%%%%%%%%%%%%%%%%%%%%%%%%%%%%%%%%%%%%%%%%%%%%%%%%%%                                                                                                                     

                                                                                                         %%%%%%%%%%%%%%%%%%%%%%%%%%%%%%%%%%%%%%%%%%%%%%%%%%%%%%%%%%%%%%%%%%%%%%%%%%%                                                                                                                         

                                                                                                       %%%%%%%%%%%%%%%%%%%%%%%%%%%%%%%%%%%%%%%%%%%%%%%%%%%%%%%%%%%%%%%%%%%%%%%%%                                                                                                                             

                                                                                                    %%%%%%%%%%%%%%%%%%%%%%%%%%%%%%%%%%%%%%%%%%%%%%%%%%%%%%%%%%%%%%%%%%%%%%%                                                                                                                                  

                                                                                                  %%%%%%%%%%%%%%%%%%%%%%%%%%%%%%%%%%%%%%%%%%%%%%%%%%%%%%%%%%%%%%%%%%%%%                                                                                                                                      

                                                                                               %%%%%%%%%%%%%%%%%%%%%%%%%%%%%%%%%%%%%%%%%%%%%%%%%%%%%%%%%%%%%%%%%%%%                                                                                                                                          

                                                                                            %%%%%%%%%%%%%%%%%%%%%%%%%%%%%%%%%%%%%%%%%%%%%%%%%%%%%%%%%%%%%%%%%%                                                                                                                                               

                                                                                          %%%%%%%%%%%%%%%%%%%%%%%%%%%%%%%%%%%%%%%%%%%%%%%%%%%%%%%%%%%%%%%%                                                                                                                                                   

                                                                                        %%%%%%%%%%%%%%%%%%%%%%%%%%%%%%%%%%%%%%%%%%%%%%%%%%%%%%%%%%%%%%                                                                                                                                                       

                                                                                      %%%%%%%%%%%%%%%%%%%%%%%%%%%%%%%%%%%%%%%%%%%%%%%%%%%%%%%%%%%                                                                                                                                                            

                                                                                    %%%%%%%%%%%%%%%%%%%%%%%%%%%%%%%%%%%%%%%%%%%%%%%%%%%%%%%%%                                                                                                                                                                

                                                                                  %%%%%%%%%%%%%%%%%%%%%%%%%%%%%%%%%%%%%%%%%%%%%%%%%%%%%%%                                                                                                                                                                    

                                                                                %%%%%%%%%%%%%%%%%%%%%%%%%%%%%%%%%%%%%%%%%%%%%%%%%%%%%                                                                                                                                                                        

                                                                              %%%%%%%%%%%%%%%%%%%%%%%%%%%%%%%%%%%%%%%%%%%%%%%%%%%                                                                                                                                                                            

                                                                             %%%%%%%%%%%%%%%%%%%%%%%%%%%%%%%%%%%%%%%%%%%%%%%%%                                                                                                                                                                               

                                                                           %%%%%%%%%%%%%%%%%%%%%%%%%%%%%%%%%%%%%%%%%%%%%%%                                                                                                                                                                                   

                                                                          %%%%%%%%%%%%%%%%%%%%%%%%%%%%%%%%%%%%%%%%%%%%%                                                                                                                                                                                      

                                                                        %%%%%%%%%%%%%%%%%%%%%%%%%%%%%%%%%%%%%%%%%%%%                                                                                                                                                                                         

                                                                       %%%%%%%%%%%%%%%%%%%%%%%%%%%%%%%%%%%%%%%%%%                                                                                                                                                                                            

                                                                      %%%%%%%%%%%%%%%%%%%%%%%%%%%%%%%%%%%%%%%%                                                                                                                                                                                               

                                                                    %%%%%%%%%%%%%%%%%%%%%%%%%%%%%%%%%%%%%%%                                                                                                                                                                                                  

                                                                   %%%%%%%%%%%%%%%%%%%%%%%%%%%%%%%%%%%%%%                                                                                                                                                                                                    

                                                                  %%%%%%%%%%%%%%%%%%%%%%%%%%%%%%%%%%%%                                                                                                                                                                                                       

                                                                 %%%%%%%%%%%%%%%%%%%%%%%%%%%%%%%%%%%                                                                                                                                                                                                         

                                                                %%%%%%%%%%%%%%%%%%%%%%%%%%%%%%%%%                                                                                                                                                                                                            

                                                               %%%%%%%%%%%%%%%%%%%%%%%%%%%%%%%%                                                                                                                                                                                                              

                                                              %%%%%%%%%%%%%%%%%%%%%%%%%%%%%%%                                                                                                                                                                                                                

                                                             %%%%%%%%%%%%%%%%%%%%%%%%%%%%%%                                                                                                                                                                                                                  

                                                            %%%%%%%%%%%%%%%%%%%%%%%%%%%%%                                                                                                                                                                                                                    

                                                           %%%%%%%%%%%%%%%%%%%%%%%%%%%%%                                                                                                                                                                                                                     

                                                          %%%%%%%%%%%%%%%%%%%%%%%%%%%%                                                                                                                                                                                                                       

                                                         %%%%%%%%%%%%%%%%%%%%%%%%%%%                                                                                                                                                                                                                         

                                                        %%%%%%%%%%%%%%%%%%%%%%%%%%%                                                                                                                                                                                                                          

                                                       %%%%%%%%%%%%%%%%%%%%%%%%%%                                                                                                                                                                                                                            

                                                      %%%%%%%%%%%%%%%%%%%%%%%%%                                                                                                                                                                                                                              

                                                      %%%%%%%%%%%%%%%%%%%%%%%%                                                                                                                                                                                                                               

                                                      %%%%%%%%%%%%%%%%%%%%%%%                                                                                                                                                                                                                                

                                                      %%%%%%%%%%%%%%%%%%%%%                                                                                                                                                                                                                                  

                                                        %%%%%%%%%%%%%%%%%%                                                                                                                                                                                                                                   

                                                         %%%%%%%%%%%%%%%%                                                                                                                                                                                                                                    

                                                         %%%%%%%%%%%%%%                                                                                                                                                                                                                                      

                                                        %%%%%%%%%%%%%%                                                                                                                                                                                                                                       

                                                       %%%%%%%%%%%%%%                                                                                                                                                                                                                                        

                                                      %%%%%%%%%%%%%                                                                                                                                                                                                                                          

                                                      %%%%%%%%%%%%                                                                                                                                                                                                                                           

                                                      %%%%%%%%%%                                                                                                                                                                                                                                             

                                                      %%%%%%%%                                                                                                                                                                                                                                               

                                                                                                                                                                                                                                                                                                             

                                                                                                                                                                                                                                                                                                             
